█████████████████████████████████████████████████████████████████████████████████████████████████████████████████████████████████████████████████████████████████████████████████████████████████████████
█                   █       █         █                 █                     █       █     █               █         █   █             █     █       █     █   █             █           █   █       █G█
█████ █████████ █ █ █████ █ █ ███████ █ █████████ ███████ ███████████████ █ ███ █ ███ █ █████ █████ ███████ █ ███████ █ █ █ █ █████████ █ █ ███ █████ █ ███ █ █ █ █ █████████ █ █████████ █ █ █ █████ █ █
█   █     █   █ █ █       █   █     █ █     █   █ █   █   █             █ █ █   █ █   █ █     █   █   █     █   █   █   █   █ █ █       █ █ █   █ █   █ █ █   █   █ █       █ █     █   █ █ █   █   █ █ █
█ █ █████ █ █ ███ █████████████ █ █ █ █████ █ █ ███ █ █ ███████████ ███ █ ███ ███ █ ███ █ █████ █ ███ █ ███████ █ █ █████████ █ █ ███████ █ █ ███ █ ███ █ █████████ ███ ███ █ █████ ███ █ █ ███████ █ █ █
█ █     █ █ █     █     █     █ █ █ █     █   █   █ █   █         █   █ █     █   █     █ █ █   █   █ █       █   █   █       █   █       █       █ █   █   █     █   █   █ █     █ █   █   █       █ █ █
█ █████ ███ ███████ █ █ █ █ ███ █ ███████ ███████ █ █████ ███████ █ █ █ ███████ ███████ █ █ █ █ █████ █████████████ ███ ███████ █████████████████ █ █ ███ █ █ ███ ███ ███ █ █████ █ █ ███████ ███ █ █ █ █
█   █   █   █       █ █ █ █ █   █       █   █     █     █   █     █ █ █       █ █       █ █   █     █     █         █   █     █ █           █   █ █       █ █   █     █   █     █   █       █   █ █ █   █
█ █ ███ █ █████ █████ █ ███ █ █████ █ █████ █ ███ █████ ███ █ ███████ ███████ █ █████ ███ ███ █████ █████ █ █████████ ███ █████ █ ███ █████ █ █ █████████████ █ ███████ ███████ ███████████ ███ █ █ ███ █
█ █   █ █ █   █   █   █     █   █ █ █ █   █ █ █ █ █   █ █   █       █ █     █ █     █   █   █ █   █   █   █ █ █   █   █         █ █   █   █   █         █   █ █ █       █                     █ █ █   █ █
█ ███ █ █ █ █ ███ █ ███████ ███ █ █ █ █ █ █ █ █ █ █ █ █ █ █████████ █ ███ ███ █████ ███████ ███ █ █ █ █ █ █ █ █ █ █ ███ █████████ █████ █ █████ ███████ █ █ ███ █ █████ █ ███████████ █████████ █ █████ █
█   █ █ █   █ █   █ █       █ █ █ █ █ █ █ █ █ █   █ █   █   █   █ █   █   █   █   █       █   █ █   █ █ █ █ █ █ █   █   █ █     █       █   █   █     █   █     █     █ █ █     █   █ █   █     █       █
█ ███ █ █████ █████ █ ███████ █ █ █ ███ █ █ █ █████ ███████ █ █ █ █████ ███ ███ █ ███████ ███ █ ███████ ███ █ █ █████ ███ █ █ █ ███████████ █ ███ ███ █████████ █████ █ ███ ███ █ ███ █ █ █ █████████████
█ █   █       █     █ █       █ █ █   █ █   █     █ █       █ █ █       █   █   █ █     █   █ █ █     █     █ █ █   █   █   █ █       █     █   █ █ █ █   █     █   █ █     █ █ █     █ █   █         █ █
█ █ ███████████ █████ ███████ █ █ ███ █ █████ ███ █ █ ███ ███ █ ███ █ ███ █████ █ █ ███ ███ █ █ █ ███ ███████ █ ███ ███ █ ███ ███████ █ ███████ █ █ █ █ █ ███████ █ ███ █████ █ █ █████ █████ ███ ███ █ █
█ █ █   █       █         █   █   █ █ █     █ █ █     █   █   █   █ █     █   █ █ █   █   █   █     █         █   █     █ █ █     █   █       █ █ █ █   █   █   █ █   █ █     █ █     █ █     █   █ █ █ █
█ █ █ █ █ ███████████████ █ █ ███ █ █ █████ █ █ ███████████ █████ █ ███████ █ █ █ ███ ███ █████ █████ █████ █ ███ █ █████ █ █████ █ ███ █████ █ █ █ ███████ █ █ █ ███ █ █ █ ███ ███████ █ █████ ███ █ █ █
█ █   █ █           █       █ █     █   █   █ █ █   █       █   █ █ █       █ █ █ █     █     █ █   █   █   █ █   █     █     █   █ █ █ █   █ █ █     █   █   █   █ █ █   █ █   █     █ █   █   █   █   █
███████ ███ ███████ █ █████████ █████ █ █ ███ █ █ █ █ ███████ ███ █ █ ███ ███ █ █ █████ ███ █ ███ █ █████ ███ █ ███████ █████ █ ███ █ █ ███ █ ███████ █ █████████ █ █ █████ █ ███ ███ █ ███ █ ███ █ ███ █
█     █   █ █       █     █     █   █ █ █ █   █ █ █   █     █     █ █ █   █ █ █ █     █ █ █ █     █       █   █ █     █ █   █ █ █ █ █       █         █ █       █   █ █     █   █ █ █ █ █   █   █ █     █
█ ███ ███ █ █ ███████ █████ █████ █ █ ███ █ ███ █ █████ ███ █ █████ ███ ███ █ █ █████ █ █ █ ███████████████ ███ █ ███ █ █ █ █ █ █ █ █ ███████████ █████ █ █████ █████ █ ███████ █ █ █ █ █ █████ █████████
█ █ █     █ █ █   █   █     █ █   █   █   █     █ █   █   █ █ █         █ █   █ █   █ █   █   █     █     █   █ █ █   █   █ █ █ █   █   █   █   █       █ █         █ █ █     █   █ █   █     █         █
█ █ ███████ █ ███ █ ███ █████ █ ███████ ███ █████ ███ █ █ █ █ ███████████ █ ███ █ ███ ███ ███ ███ ███ █ █████ █ █ █ ███████ ███ █ █████ █ █ █ █ ███████ █ █████████ █ █ █████ █████ █████████ █████████ █
█ █         █   █   █   █     █       █ █   █   █   █   █ █ █ █     █     █ █   █ █   █     █ █   █   █ █   █ █   █   █         █ █     █ █ █ █     █   █   █   █ █   █ █     █             █ █       █ █
█ █ ███████ ███ █████ █████ █ ███████ █ █ ███ █ ███ █████ █ █ █ ███ █ ███ █ █ ███ █ █████████ █ ███ ███ █ █ █ ███████ ███████████ ███████ █ █ █████ █████ █ █ █ █ █████ █ ███ ███ ███ █████ ███ █████ █ █
█ █ █     █   █ █     █     █       █ █ █ █   █   █     █ █ █   █   █ █   █ █ █   █ █         █       █ █ █ █     █ █           █       █ █ █ █   █     █ █   █ █     █   █ █   █ █   █   █   █   █   █ █
█ █ █ ███ █████ █ █████ █████ ███████ █ ███ █████ █████ █ █ █████ ███ █ ███ █ █ █ █ █ ███████ ███████ █ █ █ █████ █ ███████ ███ ███████ █ █ █ █ ███████ ███ ███ █ ███ █████ ███ ███ ███ █████ █ █ █ ███ █
█ █ █ █ █     █   █       █   █       █ █   █ █   █     █ █ █   █ █   █   █   █ █ █   █   █   █   █   █   █       █   █   █   █     █   █ █ █ █   █   █   █ █   █ █   █       █ █   █ █   █   █ █ █     █
█ ███ █ █████ █ █████████ ███ █ ███ ███ █ ███ █ ███ █████ █ █ ███ █ █████ ███████ █████ █ █ ███ █ ███ █████████████ █ █ █ ███████ █ ███ █ █ █ ███ █ █ ███ ███ ███ █████ █ ███ █ █ ███ █ █ █ ███ █ █████ █
█   █   █     █ █       █   █ █ █   █   █   █ █ █   █     █   █   █     █         █     █ █ █ █ █   █   █       █   █ █ █       █ █   █ █ █ █   █   █     █   █ █       █   █ █   █     █   █   █ █ █   █
███ ███ █ █████ █ █████ ███ █ █ ███ █ ███ █ █ █ █ █ ███ █ ███ █ ███ ███████ ███ █ █ █ █████ █ █ ███ ███ █ █ ███ █ ███ █ ███████ █████ █ █ █ ███ █████ █████ ███ █ █████████ ███████ █████████ ███ █ █ ███
█   █   █ █   █ █   █ █     █ █   █ █ █   █ █ █ █ █   █ █ █   █ █   █     █ █ █ █ █ █     █   █ █ █   █ █ █ █   █ █   █ █     █     █ █   █ █   █   █   █   █   █ █       █       █ █         █   █ █ █ █
█ ███ ███ █ █ █ ███ █ █ █████████ ███ █ ███ █ █ ███ █ ███ █████ █ ███ ███ █ █ █ ███ █████ ███ █ █ ███ █ ███ █ ███ █████ █ ███ █████ █ █████ █ ███ █ ███ ███ █ █ █ ███████ █████ ███ ███████████ ███ █ █ █
█     █   █ █ █     █ █ █   █   █ █   █   █ █ █   █ █   █       █   █ █ █ █   █   █ █   █   █ █ █     █     █ █       █   █   █     █ █   █ █     █ █ █     █ █ █     █       █ █   █   █       █ █   █ █
█ █████ ███ █ ███████ █ █ █ █ █ █ █ ███ ███ █ ███ █████ █ ███████████ █ █ ███ ███ █ █ █ █ ███ █ █ ███████████ ███████ █████ ███ █████ █ ███ █ █████ █ █████████ █████ █ █ █████ █ ███ █ █ ███████ █ ███ █
█     █     █   █       █ █ █ █   █ █   █   █     █     █             █ █ █ █ █ █   █ █   █   █ █ █     █           █     █ █ █       █   █ █ █     █               █   █ █     █   █ █   █   █ █   █   █
█████ █████████ █ ███████ █ █ █ ███ █████ ███ █████ ███████████████████ █ █ █ █ █████ █████ ███ █ █ ███ ███████████ █ ███ █ █ █████████ █ █ █ █ █████████ █ █████████████ █ ███████ █ █████ █ █ █ █████ █
█             █ █   █     █   █ █   █     █ █       █     █       █   █   █       █   █   █   █ █   █   █         █   █   █ █   █     █ █   █ █ █ █       █ █         █ █ █ █     █ █ █   █ █   █ █     █
███████████████ ███ █ █████ █████ ███ █████ █████████ ███ █ █████ █ █ █ ███████████ ███ █ █ ███ █████ ███ ███████ █████ ███ █ █ █ ███ █ ███████ █ █ █ ███████ █████ █ █ █ █ █ ███ █ █ █ █ █ █████ █ ███ █
█ █         █   █   █ █   █ █   █   █ █       █     █ █ █   █   █   █   █         █     █   █   █   █ █       █ █ █       █ █ █   █ █   █     █ █ █ █         █   █ █   █ █ █   █   █   █ █       █ █   █
█ █ ███████ █ ███ ███ █ █ ███ █ ███ █ █ █ █████ ███ █ █ ███████ ███████████ █████ ███████████ ███ █ █ ███████ █ █ █████████ █ █████ ███████ █ █ █ █ █████████████ █ █████ █ ███ █████████ █ ███████ █ ███
█S  █         █     █   █     █       █ █         █                         █                 █   █           █             █               █   █                 █       █               █         █   █
█████████████████████████████████████████████████████████████████████████████████████████████████████████████████████████████████████████████████████████████████████████████████████████████████████████
