█████████████████████████████████████████████████████████████
█         █     █         █   █               █         █  G█
███████ ███ █ █ █ █████ █ ███ █ ███████████ █ ███ █████ █ █ █
█   █   █   █ █ █ █     █   █ █ █   █       █   █   █   █ █ █
█ █ █ ███ ███ █ ███ ███████ █ █ █ █ █ █████████ ███ █ █████ █
█ █   █     █ █   █     █   █   █ █ █     █       █ █   █   █
█ ███ █ █████ ███ █████ █ █████ █ █ █████ ███████ █ ███ █ ███
█ █   █ █   █   █       █     █   █ █   █     █ █   █   █   █
█ █ ███ █ █ ███ █████████████ █ █████ █ ███ █ █ █████ █████ █
█ █ █   █ █ █   █         █   █ █   █ █   █ █ █             █
█ ███ ███ █ █ █████ ███████ █████ █ █ ███ ███ █████████████ █
█       █ █ █     █         █     █   █   █   █   █   █   █ █
█ ███████ █ █ ███ █ █████████ █████████ ███ ███ █ █ █ █ ███ █
█ █   █   █ █ █   █   █     █ █     █   █   █   █   █ █     █
█ ███ █ ███ ███ █████ █ ███ █ █████ █ █████ █ ███████ █ █████
█     █   █ █   █   █   █   █     █ █     █       █   █ █   █
█████ ███ █ █ ███ ███████ ███████ █ █████ █████████ ███ █ █ █
█ █     █ █ █ █ █       █   █     █     █ █     █   █ █ █ █ █
█ ███████ █ █ █ █ ███ █████ █ █████ █ ███ █ ███ █ ███ █ █ █ █
█S        █   █     █         █     █       █     █       █ █
█████████████████████████████████████████████████████████████
